alch vulg	alch spec ies
dant decu	dant decu decu
pimp majo	pimp majo slat
poly amar	poly amar ella
trif mont	trif mont mont
dact glom	dact glom glom
poly vivi	pers vivi
trif prat	trif prat prat
care semp	care semp semp
fest nigr	fest nigr cens
gymn cono	gymn cono cono
hier pila	hier pilo ella
pimp saxi	pimp saxi slat
sesl albi	sesl caer
trif medi	trif medi medi
fest prat apen	fest prat appe
gent clus	gent clus clus
lath prat	lath prat prat
care flav	care flav aggr
plan majo	plan majo majo
chae hirs hirs	chae hirs
dact macu fuch	dact macu slat
phle prat prat	phle prat
prim elat elat	prim elat
anth vuln alpe	anth vuln alpi
cala alpi	clin alpi alpi
card defl defl	card defl viri
linu cart	linu cath
pyro unif	mone unif
rume arif	rume alpe
sile nuta	sile nuta nuta
euph rost mont	euph offi rost
rume acet	rume acet osa
orch ustu	neot ustu
heli numm	heli numm slat
aven pube	homa pube pube
sang mino	sang mino mino
aste bell	bell mich
crep aure	crep aure aure
thym pule	thym pule pule
hier spec	hier spec ies
sorb aria aria	sorb aria aggr
luzu sylv	luzu sylv sylv
poly alpe	poly alpe alpe
vera albu	vera albu slat
acon vari	acon vari slat
dent enne	card enne
will stip	will stip stip
soli virg	soli virg virg
knau dips dips	knau maxi
sene abro	sene abro abro
aden glab	aden alpi
vero frus	vero frut cans
care fusc	care nigr
cyst frag alpi	cyst alpi
urti dioi	urti dioi dioi
micr mono	mala mono mono
ligu muta	mute adon
euph pict	euph offi pict
fest quad	fest pumi
pedi roca	pedi rost tata
vacc viti idae	vacc viti
hera aust	hera aust aust
junc trif mona	junc mona
luzu alpi	luzu alpi na
prim auri	prim auri auri
clin vulg	clin vulg vulg
lami gale mont	gale mont
fica vern	fica vern vern
myos arve	myos arve arve
luzu luzs	luzu luzu ides
care oval	care lepo
dact maja	dact maja slat
rume obtu	rume obtu obtu
stel nemo nemo	stel nemo
stac alop	beto alop
sene ovat	sene ovat ovat
hier pilm	hier pilo sum
arab pumi bell	arab bell
priz alpi	horn alpi alpi
sedu atra	sedu atra atra
alch spec	alch spec ies
sagi sagi	sagi sagi ides
rhin alec	rhin alec alec
knau arve	knau arve arve
trag prat orie	trag orie
fest rupr	fest rupi rina
aren cili cili	aren cili
koel pyra	koel pyra pyra
stac offi	beto offi offi
vale wall	vale offi tenu
vale offi	vale offi offi
crep moll	crep moll slat
card pers	card pers pers
cent scab	cent scab scab
alli cari	alli cari cari
vale dioi	vale dioi dioi
dact inca	dact inca inca
sali elae	sali elea elea
lase lati	lase lati lati
plan atra	plan atra atra
lase sile	lase sile sile
lami gale flav	gale flav
lina alpi	lina alpi alpi
acon nape	acon nape slat
chae hirs vill	chae vill
epil spec	epil spec ies
tolp stat	chlo stat
juni comm	juni comm comm
card amar	card amar aust
juni sibi	juni comm nana
alli sene mont	alli lusi
card spec	card spec ies
leon helv	scor helv
euph amyg	euph amyg amyg
athy fili femi	athy fili
pseu albi	pseu albi slat
hedy hedy	hedy hedy hedy
sile alba	sile lati alba
conv maja	conv maja maja
dryo fili mas	dryo fili
pedi rosp	pedi rost cata
puls alpi	puls alpi alpi
