card defl	card defl viri
carl vulg	carl vulg vulg
corn sang	corn sang slat
dact glom	dact glom glom
epip hell	epip hell slat
eric herb	eric carn
erig acri ac	erig acri acri
erig annu	erig annu slat
hier sylv	hier muro
juni comm c	juni comm comm
lari deci	lari deci deci
prun aviu	prun aviu slat
soli virg	soli virg virg
achi mill m	achi mill aggr
agro tenu	agro capi
anth vuln	anth vuln slat
aven pube	homa pube pube
cent jace	cent jace jace
cent scab	cent scab scab
fest prat	fest prat prat
knau arve	knau arve arve
koel pyra	koel pyra pyra
lath prat	lath prat prat
leon hisp	leon hisp slat
pimp majo	pimp majo majo
sile nuta	sile nuta nuta
sile vulg v	sile vulg vulg
thym pule	thym pule pule
trif prat p	trif prat prat
hera spho s	hera spho spho
ranu acri	ranu acri acri
rume acet	rume acet osa
salv prat	salv prat prat
tara offi	tara sect rude
tris flav	tris flav flav
vero cham c	vero cham cham
euph rost	euph offi rost
fest amet	fest amet amet
fest rubr r	fest rubr slat
thal minu	thal minu slat
ange sylv	ange sylv sylv
bryu pseu	bryu pseu pseu
dact maja b	dact maja brev
drep coso	scor coss
drep revo	scor revo
gali palu	gali palu palu
gymn cono	gymn cono cono
moli caer a	moli caer aggr
palu comm	palu comm comm
poly amae	poly amar ella
poly bist	pers bist
sali rosm	sali repe rosm
sesl vari	sesl caer
vale dioi	vale dioi dioi
alli cari	alli cari cari
heli prae	aven prae
thes pyre a	thes pyre alpe
dant decu	dant decu decu
picr hier	picr hier slat
bisc laev	bisc laev laev
care semp	care semp semp
dian cart	dian cart cart
gent vern	gent vern vern
heli numm	heli numm numm
lili bulb	lili bulb bulb
pimp saxi	pimp saxi slat
poly vivi	pers vivi
trif mont	trif mont mont
plan majo m	plan majo majo
trif medi	trif medi medi
knau dips	knau maxi
peuc cerv	cerv rivi
sang mino mi	sang mino mino
visc laxu	visc laxu laxu
aste bell	bell mich
carl acau	carl acau slat
rubu frut	rubu sect rubu
epip x sc	epip hell atro
sile glar	sile vulg glar
thym poly	thym prae poly
care pann	care pani pani
dact inca	dact inca inca
lych flos	lych flos cucu
conv maja	conv maja maja
prun padu	prun padu padu
ribe sp	ribe spec ies
sorb aucu	sorb aucu aucu
prun cers	prun cera ifera
myce mura	lact mura
urti dioi	urti dioi dioi
onon repe	onon repe proc
care muri	care poly
chen albu	chen albu slat
past sati	past sati sati
rume obtu	rume obtu obtu
clin vulg	clin vulg vulg
hier pila	hier pilo ella
leon hyos	leon hisp hyos
sali elea	sali elea elea
sang mino mu	sang mino bale
thym prae	thym prae prae
myos palu	myos palu aggr
card amar	card amar aust
care grac	care acut a
fest arun	fest arun slat
fili ulma u	fili ulma slat
vale offi	vale offi offi
vero anag	vero anag tica
rham saxa	rham saxa saxa
hier pilo	hier pilo ides
palu falc	palu comm falc
poly amar b	poly amar brac
coro vari	secu vari
fest rupi	fest stri sulc
hier stat	chlo stat
alli mont	alli lusi
lase lati	lase lati lati
lase sile	lase sile sile
botr isch	both isch
cony cana	erig cana
agro repe	elyt repe
cala neps	clin nepe
care flav	care flav slat
pedi palu	pedi palu palu
tetr mari	lotu mari sili
junc alpi	junc alpi alpi
lyco euro e	lyco euro euro
ment x ve	ment vert
betu pube	betu pube slat
sali x my	sali myrs cine
hyme recu	hyme recu recu
marc aqua	marc poly poly
char sp	char spec ies
dact macu	dact macu slat
dact maja	dact maja maja
musc sp	musc species
